Height: 50
Width: 50
00000000000000001100000000000000000000000000000000
00000000000000001100000000000000000000000000000000
00000000000000001100000000000000000000000000000000
00000000000000001100000000000000000000000000000000
00000000000000001100000000000000000000000000000000
00000000000000001100000000000000000000000000000000
00000000000000001100000000000000000000000000000000
00000000000000001100000000000000000000000000000000
00000000000000011110000000000000000000000000000000
00000000000000111111000000000000000000000000000000
00000000000001111111100000000000000000000000000000
000000000000111111111100000000000000000000000000000
000000000001111111111110000000000000000000000000000
00000000001111111111111100000000000000000000000000
22222222222222222222222222222222222222222222222222
22222222222222222222222222222222222222222222222222
22222222222222222222222222222222222222222222222222
00000000000000000000000000000000000000000000000000
00000000000000000000000000000000000000000000000000
00000000000000000000000000000000000000000000000000
00000000000000000000000000000000000000000000000000
00000000000000000000000000000000000000000000000000
00000000000000000000000000000000000000000000000000
00000000000000000000000000000000000000000000000000
00000000000000000000000000000000000000000000000000
00000000000000000000000000000000000000000000000000
00000000000000000000000000000000000000000000000000
00000000000000000000000000000000000000000000000000
00000000000000000000000000000000000000000000000000
00000000000000000000000000000000000000000000000000
00000000000000000000000000000000000000000000000000
00000000000000000000000000000000000000000000000000
00000000000000000000000000000000000000000000000000
00000000000000000000000000000000000000000000000000
00000000000000000000000000000000000000000000000000