Height: 50
Width: 50
01100000000000000000000000000000000000002222200000
01100000000000000000000000000000000000002222200000
01100000000000000000000000000000000000002222200000
01100000000000000000000000000000000000002222200000
01100000000000000000000000000000000000002222200000
01100000000000000000000000000000000000002222200000
01100000000000000000000000000000000000002222200000
01100000000000000000000000000000000011112222200000
01100000000000000000000000000000000011112222200000
01100000000000000000000000000000000011112222200000
01111111111111111111111111111111111111112222200000
01111111111111111111111111111111111111112222200000
00000000000000000000000000000000000011112222200000
00000000000000000000000000000000000000002222200000
22222222222222222222222222222222222222222222200000
22222222222222222222222222222222222222222222200000
22222222222222222222222222222222222222222222200000
00000000000000000000000000000000000000002222200000
00000000000000000000000000000000000000002222200000
00000000000000000000000000000000000000002222200000
00000000000011111111111111100000000000002222200000
00000000000011111111111111100000000000002222200000
00000000000011222222222221100000000000002222200000
00000000000011222222222221100000000000002222200000
00000000000011222222222221100000000000002222200000
00000000000011222222222221100000000000002222200000
00000000000011222222222221100000000000002222200000
00000000000011222222222221100000000000002222200000
00000000000011222222222221100000000000002222200000
00000000000011222222222221100000000000002222200000
00000000000011222222222221100000000000002222200000
00000000000011222222222221100000000000002222200000
00000000000011111111111111100000000000002222200000
00000000000011111111111111100000000000002222200000
00000000000000000000000000000000000000002222200000